N N N N N N N N N N N N N N N 
N N N N N N N O1 N N N N N N N
N N M M M M M M M M M M E N N
N N M M M M M M E M M M M N N
N N M M M M M M M M M E M N N
N N M M M M M M M M M M M N N
N O2 M M M M M E E M M E M O3 N
N N M M M M M M M M M M M N N
N N M M M M M M M M M M M N N
N N M M M M M M M M M M M N N
N N M M M M M M M M M M M N N
N N N N N N N O4 N N N N N N N
N N N N N N N N N N N N N N N